00000000000000000000
11111111111111111111
22221222222222222222
11111111111111111111
11111111111111111111
00000000000000000000
11111111111111111111
22221222222222222222
11111111111111111111
11111111111111111111
00000000000000000000
11111111111111111111
22221222222222222222
11111111111111111111
11111111111111111111
00000000000000000000
11111111111111111111
22221222222222222222
11111111111111111111
11111111111111111111
